die Bank : banka
der Kunde : moška stranka
die Kundin : ženska stranka
der Geldautomat : bankomat
der Schalter : okence
der Bankschalter : okence na banki
das Geld : denar
das Bargeld : gotovina
das Kleingeld : drobiž
barbezahlen : plačati z gotovino
die Bedingung : pogoj
der Betrag : znesek
die Gebühr : taksa
der Beleg / die Quittung / die Rechnung : račun/potrdilo
die EC-Karte : kartica z elektronskim denarjem
die Kreditkarte : kreditna kartica
das Konto : bančni račun
das Girokonto : transakcijski bančni račun
das Sparkonto : varčevalni bančni račun
das Tagesgeldkonto : bančni račun za vsakdanjo rabo
die Kontonummer : številka bančniškega računa
die Bankleitzahl : karakteristična številka banke
die Geheimzahl : skrivna številka/koda/pin
die PIN : PIN številka
der Zins : obrest
die Schulden : dolg/-ovi 
anlegen : polagati (denar, napisi samo glagol) 
abheben : dvigniti (denar, napisi samo glagol)
einzahlen / überweisen : nakazati denar na račun
eröfnen : odpreti (bančni račun, napisi samo glagol)
die Überweisung / die Einzahlung : nakazilo
der Dauerauftrag : trajni nalog
der Zweck : namen
der Verwendungszweck : namen uporabe
sperren : prekiniti (kartico, napisi samo glagol)
die Zahlung : plačilo
kostenfrei / kostenlos : brezplačno/brez stroškov
sparen : varčevati
sparsam : varčen
die Sparkasse : hranilnica
die Auszahlung : izplačilo
die Anlage : polog
die Geldanlage : denarni polog
die Kosten : stroški
der Kredit : kredit